1	2	3	3	3	3	3	3	3	3	3	3	3	3	3	4	5
5	25	25	25	7	8	9	8	10	8	11	8	9	25	25	12	5
5	25	25	25	13	25	25	25	13	25	25	25	13	25	25	12	5
5	8	14	8	15	25	25	25	16	8	17	8	18	25	25	12	5
5	25	25	25	19	25	25	25	13	25	25	25	25	25	25	12	5
5	25	25	25	16	8	20	8	21	25	25	22	23	24	25	12	5
5	25	25	25	13	25	25	25	25	22	23	26	27	28	25	12	5
5	25	25	29	16	29	18	8	9	30	9	8	32	33	25	12	5
5	25	29	29	13	29	29	25	13	33	25	25	25	33	25	12	5
5	25	29	29	34	8	9	8	35	36	23	23	23	26	25	12	5
37	38	38	38	38	38	38	38	38	38	38	38	38	38	38	39	5